25x15
111  1111   111111  111111
              9
        1
        1        1
        1   111111
            111111
1111111